TILEMAP
16 16 							-- Size of tile map in tiles
32 32							-- Tile size & block size
images/walls.png 	-- Tilesheet
8 5 								-- Number of tiles in tilesheet
 9   9   9  11   9   9   9   9   9   9   9  10  32  32   8   9
 9   9   9   9   9  11   9   9  14  14  14  15  32  32   8   9
 9   9  14  14  14  14  14  15   1   2   2   3  32  32   8   9
 9  10   1   2   3   7   1   3  13  14  14  15  32  32   8   9
14  15   8   9  10  35  13  15   7  32  32  32  32  33   8   9
32  32  13  14  15  32  32  31   0  30   0  30  32  32   8   9
32  32   0   0   0  32  32   0   0   0   0   0  30   1   9  11
33  32  29   0   0   0  30  31   0   0   0   0   0  13  14  14
32  32  32  31   0   0   0   0   0   0  28  34  28  32  32   0
32  31   0   0   0   0   0   0   0   0  30  32  32  32  31   0
32   0   0   0  29  32  29   0   0   0   0   0  32  32   0   0
32   0  28  32  32  35  32  32   0   0   0  28  32  31   0   0
 2   2   3  32  32  32  32  32  29   0   0  32  33  32  38   0
 9   9   9   2   2   2   3  32  32  32  32  35  32  32   1   2
 9  11   9   9   9   9  10  30  32  32   1   2   2   2   9   9
 9   9   9   9  11   9  10   0   0  30   8   9   9   9  11   9