TILEMAP
16 16 							-- Size of tile map in tiles
32 32							-- Tile size & block size
images/walls.png 	-- Tilesheet
2 2 								-- Number of tiles in tilesheet
1111111111111111
11            11
11            11
11            11
11            11
11            11
11            11
1111   11114  11
11           111
11            11
11            11
11            11
1111   1113   11
11            12
11            11
1111111111111111

