TILEMAP
16 16 							-- Size of tile map in tiles
32 32							-- Tile size & block size
images/walls.png 	-- Tilesheet
8 5 								-- Number of tiles in tilesheet
 9   9  10  32  32  32  32   8   9  14  14  14  14   9  11   9
 9  11  10  32  33  32  32  13  15  33  32  31   0  13  14   9
 9   9  10  32  32  32  32   7  32  31  30   0   0   0  30  13
 9   9  10  32  31   0  32   7  34   0   0   0   0   0   0   0
 9   9  10  12   0   0  30   7  31   0   0   0   0   0   0   0
11   9  10  17   0   0   0  31   0   0   0   0   0   0   0  28
14  14  15   7   0   0   0   0   0   0   0   0   0  12  32  32
 5   5   5   6   0   0   0   0   0   0   0   0   0  16  32  33
32  32  32   4   6   7   0   0   0   0   0   0   7  16  32  32
32  33  35  31  30   0   0   0   0   0   0   0  30  17  35  32
32  32  32   0   0   0   0   0   0   0   0   0   0  30  32  32
32  31  30   0   0   0   0   0   0   0   0   0   0   0  32  30
30   0   0   0   0   0   0   0   0   0   0   0   0  30  32   0
 0   0   0   0   0   0   0   0   0   0   0   0   0   0  31   0
 0  12  29   0   0   0   0   0   0   0   0   0   0   0   0   0
28  16  33   0   0   0   0   0   0   0   0   0   0   0   0   0