TILEMAP
16 16 							-- Size of tile map in tiles
32 32							-- Tile size & block size
images/walls.png 	-- Tilesheet
8 5 								-- Number of tiles in tilesheet
 9   9   9   9   9   9  14  15  32  33  32  32  13   9   9   9
 9  11   9   9   9  10   0  30  32  32  31  32  35   8  11   9
 9   9   9  11   9  15   0   0  31   0   0  30   0  13   9   9
 9  14   9   9  10   0   0   0   0   0   0   0   0   0  13   9
15   0  13   9  15  38  37   0   0   0   0   0   0   0   0  13
 0   0   0  17   1   2   3   0   0   0   0   0   0   0   0   0
 0   0   0   0   8   9  10   0   0   0   0   0   0   0   0  26
 0   0   0  28  13  14  14   5   5   5   6  34   0   0   0  27
 0   0   0  32  32  32  32  32   7   7  32  32  32  29   1   2
 0   0  28  32  33  32  35  31   0   0  30  32  33  32   8   9
 0   0   0  30  32  32  32   0   0   0   0  32  35  32   8   9
 0   0   0   0   0  30  32   0   0   0   0  32  32  32   8  11
 0   0   0   0   0   0  32   4   2   2   6  31  30   0   8   9
 0   0  37   0   0   0  30  32   8  10  31   0   0   0   8   9
 2   2   3   0   0   0   0  30   8  10   0   0   0   0   8   9
 9  11  10   0   0  12   0   0   8  10   0   0   0   1   9   9

