TILEMAP
16 16 							-- Size of tile map in tiles
32 32							-- Tile size & block size
images/walls.png 	-- Tilesheet
8 5 								-- Number of tiles in tilesheet
 9  10   8   9   9  10  13  14  14  14   9  10  32  32  32   8
 9  10  13  14  14  15  32  32   0  32   8  10  30  35  32   8
 9   9   3   7  35  32  31  31   0  32   8  10   0  28  33   8
11   9  10  32  32  31   0   0   0  30   8  15   0   0  30   8
 9  11  10  31   0   0   0   0   0   0  16   0   0   0   0   8
 9  14  15   0   0   0   0   0   0   0  17   0   0   0  36   8
10   0  38   0  28  29   0  12   0   0   0   0   0   0   1   9
 9   3   7   7  35  31   0  16  29   0   0   0   0   0   8  11
 9   9   2   3  32  29   0  17  32  32  29   0  32  32  13  14
 9   9  11  10  32  32  29   7  32  32  32  33  32  32   1   2
11   9   9  10   0  30  32  16  31   0  30  32  32   4  14   9
14  14   9  10   0  28  32  16   0   0   0   0  30  32  32   8
 0  32  13  10  28  33  31  16   0   0   0   0   0   0  30  13
 0  30  33  17  32  31   0  16   0   0   0   0   0   0  28  32
 0   0  30  32  32  34  37   8   2   2   3   0   0   0  33  32
 2   2   2   2   2   2   2   9   9  11  10  34  32  32  32  32