TILEMAP
16 16 							-- Size of tile map in tiles
32 32							-- Tile size & block size
images/walls.png 	-- Tilesheet
8 5 								-- Number of tiles in tilesheet
 0   0   0   0   0   0   0   0   0   0   0   0   0   0   0   0
 0   0   0   0   0   0   0   0   0   0   0   0   0   0   0   0
 0   0   0   0   0   0  28   0   0   0   0   0   0   0   0   0
 0   0   0   0   0   0  35   0   0  29   0   0   0   0   0   0
 0   0   0   0  28   0  32   0   0  33   0   0   0   0   0   0
 0   0   0   0  32  34  32   0   0  35   0  29   0   0   0   0
 0   0   0   0  32  33  32   0   0  32  34  32   0   0   0   0
 0   0   0   0  30  32  32   1   3  32  33  31   0   0   0   0
 0   0   0  28  33  32   1   9   9   3  32  29  28   0   0   0
 0   0   0  30  32   1   9  11   9   9   3  32  33  32   0   0
 0   0  28  32  31   8   9   9   9   9  10  35  32  32  32   0
32  35  32  33   0  13  14   9   9  11  10  31   0  30  32   0
 0  30  32  29  37   1   3   8   9  14  15   7   0   0  32   0
 0   0   1   2   2   9  10  13  15   1   2   3  32  29  32  32
 0   0  13   9   9  11   9   2   2   9   9   9   3  35  33  32
 1   2   3   8   9   9   9   9   9   9  11   9   9   2   2   3